11111111111111111111111111
10C0100000100CC000000C0001
10000011001P00011000000C01
10000000001C111001111C1111
10001111001C00011000000001
10000C00001C0001C000000C01
10C01000000000C00000000001
10001111000C00011000000001
10E00001100C111000011C1111
1000101110000C000000001001
100C100C000000000001001001
100010000C000C001110000001
100000C000000000001CCC0001
11111111111111111111111111