11111111111111111111111111
1000100000000CC00000001111
10001111000P00011000000001
10E00000000C111111111C1111
10001111000C00011000000001
10000000000C00011000000001
11111111111111111111111111