
1111111111111
1000000000001
10000000P0001
10000E00000C1
1111111111111
