1111111111111
1000000000001
1000000000001
10000E00P00C1
111111111