1111111111111
1000000000001
1000000000001
10020E00P00C1
1111111111111
