1111111111111
100 000000001
1000000000001
10000E00P00C1
1111111111111