1111111111111
100010000C001
1C00100E00001
10000100P00C1
1111111111111