1111111111111
100010000C001
1C00100000001
10000E00P00C1
1111111111111