111111111111111111
10E010000C00000001
1C0010000000000001
100011100P00C00001
100000100000000001
111111111111111111
