111111111111111111
100010000C00000001
1C0010000000000001
10E011100P00C00001
100000100000000001
111111111111111111