111111111111111111111111111111111111111111111111111111111111
10C0100000100CC000000C00000000000000000000000000000000000001
10001111001P00011000000C011111111111111111111111111111111101
10000000001C111001111C11111111111111111111111111111111111101
10001111001C000110000000011111111111111111111111111111111101
10000C00001C0001C000000C011111111111111111111111111111111101
10C01000000000C000000000011111111111111111111111111111111101
10001111000C000110000000011111111111111111111111111111111101
10E00001100C111000011C11111111111111111111111111111111111101
1000101110000C0000000010011111111111111111111111111111111101
100C100C0000000000010010011111111111111111111111111111111101
100010000C000C0011100000011111111111111111111111111111111101
100010C000000000001CCC00011111111111111111111111111111111101
101111111111111111111111111111111111111111111111111111111101
101111111111111111111111111111111111111111111111111111111101
101111111111111111111111111111111111111111111111111111111101
101111111111111111111111111111111111111111111111111111111101
101111111111111111111111111111111111111111111111111111111101
100000000000000000000000000000000000000C00000000000000000001
111111111111111111111111111111111111111111111111111111111111