1111111111111111111111111111111111111111111111111111111111111
10C0100000100CC000000C000111111111111111111111111111111111111
10001111001P00011000000C0111111111111111111111111111111111111
10000000001C111001111C111111111111111111111111111111111111111
10001111001C0001100000000111111111111111111111111111111111111
10000C00001C0001C000000C0111111111111111111111111111111111111
10C01000000000C0000000000111111111111111111111111111111111111
10001111000C0001100000000111111111111111111111111111111111111
10E00001100C111000011C111111111111111111111111111111111111111
1000101110000C00000000100111111111111111111111111111111111111
100C100C00000000000100100111111111111111111111111111111111111
100010000C000C00111000000111111111111111111111111111111111111
100010C000000000001CCC000111111111111111111111111111111111111
1111111111111111111111111111111111111111111111111111111111111
1111111111111111111111111111111111111111111111111111111111111
1111111111111111111111111111111111111111111111111111111111111
1111111111111111111111111111111111111111111111111111111111111
1111111111111111111111111111111111111111111111111111111111111
1111111111111111111111111111111111111111111111111111111111111
1111111111111111111111111111111111111111111111111111111111111
1111111111111111111111111111111111111111111111111111111111111